################################################################################################################################
#-X----------##########---------------------------------#------------------------------------------------#-------------,,,,,,,,#
#------0000000-------##---------------------------------#------------------------------------------------#-------------,,,,,,,,#
#------------0-------##---------------------------------#------------------------------------------------#-------------,,,,,,,,#
###########--0-------##---------------------------------#------------------------------------------------#-------------,,,,,,,,#
#*********#--0-------##---------------------------------#---------------------------------#--------------#---------------------#
#*********#--0-------#########################Y##########################-----------------#--------------#---------------------#
#*********#--0-------##-----,,,,,,,,------------------------------------------------------#--------------#---------------------#
#*********Y--0000-----------,,,,,,,,------------------------------------------------------#--------------#---------------------#
#*********#-----0-----------,,,,,,,,------------------------------------------------------#--------------#-----0---------------#
#*********#-----000000000000wwwwwwww0000000000--------------------------------------------#--------------#----YYY---############
###########-----0-----------,,,,,,,,--------------------------#############################--------------------0---------------#
#---------------0-----------,,,,,,,,------------------------------------------------------#------------------------------------#
#---------------0-----------,,,,,,,,------------------------------------------------------##########---------------------------#
#---------------0----#################################------------------------------------#------------------------------------#
#---------------0---------------#------------------------------------------------------------------------0000000000------------#
#---------------0---------------#----------------------------------------------------------------------------------------------#
#-------------------------------#----------0000000000--------------------------------------------------------------------------#
#-------------------------------#-----------------------#-----------------##########################---------------------------#
#-------------------------------#-----------------------#-----------------#----------------------------------------------------#
######################---------------------#------------#-----------------#----------------------------------------------------#
#,,,,,,,-----------------------------------#------------#---------------,,#----------------------------------------------------#
#,,,,--------------------------0-----------#--------------------------,,,,#----------------------------------------------------#
#,,,,,,,,,,,-------------------0-----------#-----------------------,,,,,,,#--------------------#################################
#,,,,,,,,,,,,,,,---------------0-----------#--------------------,,,,,,,,,,#---------#-----------------------#******************#
#,,,,,,,,,,,,,,,,,,,,----------0-----------#------------###################---------#-----------------------#******************#
#,,,,,,,,,,,,,,,,,,,,----------0-----------#------------------------------#---------#-----------------------#******************#
#########################------0-----------#------------------------------#---------#-----------------------#******************#
#-----------------#------------0-----------#------------------------------#--------####################-----#******************#
#-----------------#------------0-----------################################---------------------------------#******************#
#-----------------#------------0-----------#------------------------------#---------------------------------#******************#
#-----------------#-------000000-----------#------------------------------#---------------------------------#******************#
#-----------------#------------------------#------------------------------#---------------------------------#******************#
#-----------------#------------------------#------------------------------#----------------##################******************#
#-----------------Y------------------------#--------------------#---------#------------------------****************************#
#-----------------#-----------################------------------#---------#------------------**********************************#
#-----------------#--------------------------#------------------#---------#----------------------******************************#
#-----------------#--------------------------#------------------#---------#---------------------------*************************#
#-----------------#--------------------------#------------------#---------#--------------------------------********************#
###################--------------------------#------------------#---------#---------------------------------*******************#
#,,,**K**,,,#--------------------------------#------------------#--------------------------------------------******************#
#***********#---------------------------------------------------#-------------------------######################################
#***********#-----------------000000000000000000----------------#----------00-------#-----------------------#------------------#
#***********#--------------------------------------------##############----00-------#-----------------------#------------------#
#***********#--------------------------------------------------------------00-------#-----------------------#------------------#
###------######################################----------------------------00-------#--------------------------000000000-------#
#------------------#-------------------------------------------------------00-------#----------------------------------0-------#
#--------------------------------00000000000000000000000000000000000000000000-------#---------###################------0-------#
#--------------------------------00000000000000000000000000000000000000000000-------#-------------------0000000000000000-------#
#------------------#-------------00-------------------------------------------------#-----------------------#----------0-------#
#------------------#-------------00-----------------------#-------------------------#-----------------------#----------0-------#
####################-------------00-----------------------#-------------------------#-----------------------#------------------#
#---------------------------------------------------------#-------------------------#-----------------------#------------------#
#---------------------------------------------------------#-------------------------#-----------------------#------------------#
#----------------------------###################################################################################################
#----------------------------#**************************************************-----------------------------------------------#
#----------------------------#**************************************************-----------------------------------------------#
#----------------#############-----------------------------------------------------------------------###########################
#----------------------------#-------------------------------------------------------------------------------------------------#
#----------------------------#----------------------------------------------#--------------------#--------000000000----0-------#
#----------------------------#----------------------------------------------#--------------------#---------------------0-------#
#---------------------------------------------------------------------------#--------------------#############-----------------#
#---------------------------------------------------------------------------#--------------------#---------------0000000---00--#
#---------------------------------------------------------------------------#--------------------#-----------0-----------------#
#######################################################---------------------#--------------------#-----------0------############
#------------------#---------------------#----------------------------------#--------------------#-----------------------------#
#------------------#---------------------#-------------------------------------------------------#------------0000000000-------#
#------------------#---------------------#-------------------------------------------------------#-----------------------------#
#------------------#---------------------#-------------------------------------------------------#-----------------,,,,,,,,,,,,#
#------------------#---------------------#----------------------##################################---------------,,,,,,,,,,,,,,#
#-----0------------#---------------------#------------------------------------#------------------#-------------,,,,,,,,,,,,,,,,#
#-----0------------#---------------------#------------------------------------#------------------#----------####################
####--0--###########---------------------#------------------------------------#------------------------------------------------#
#-----0----------------------------------#------------------------------------#------------------------------------------------#
#-----0000000----------------------------#--------------#---------------------#---------0--------------------------------------#
#----------------------------------------#--------------#---------------------#---------0--------------------------------------#
#----------------------------------------#--------------#---------------------#---------0--------------------------------------#
##################-----------------------#--------------#---------------------#---------0--------------------------------------#
#----------------------------------------#----------------------------------------------0--------------------------------------#
#----------------------------------------#----------------------------------------------0---------------#----------------------#
#----------------------------------------########################################-------0---------------####################---#
#----------------------------------------#----------------------------------------------0---------------#----------------------#
#----------------------------------------#---------------------0----------------------------------------#----------------------#
#------------##############################################----0-----#----------------------------------#----------------------#
#------------#*************************************************0*****#----------------------------------#----------------------#
#------------#*************************************************0*****#----------------------------------#----------------------#
#------------#**************************************000000000000*****#-------------######################----------------------#
#------------#***************00000***********************************#----------------------------------#----------------------#
#------------#****************************00000**********************#----------------------------------#----------------------#
#------------#*******************************************************#----------------------------------#----------------------#
#------------#*******************************************************#----------------------------------#----------------------#
#------------################################################################---------------------------#----------------------#
#-------------------------------------------------------------------------------------------------------#----------------------#
#------------------------------------------------------------------------------------------------------------------------------#
#------------------------------------------------------------------------------------------------------------------------------#
################################------------------------#######################################------------#-------------------#
#------------------------------#------------------------#--------------------------------------------------#-------------------#
#-------,,,,,,,,,,,------------#------------------------#***********---------------------------------------#-------------------#
#-------,,,,,,,,,,,------------#------------------------#***********---------------------------------------#-------------------#
#-------###########------------#------------------------#***********##############--------------------##############-----------#
#------------------------------#------------------------#***********##############--------------------#------------------------#
#------------------------------#------------------------#***********----------------------------------#------------------------#
#------------------------------#------------------------#***********----------------------------------#------------------------#
#------------------------------#---------#--------------#---------------------------------------------#------------------------#
#------------------------------#---------#--------------######################--------#######################------------------#
#------#########################---------#-----------------------------------#------------------------------#------------------#
#----------------------------------------#-----------------------------------#------------------------------#------------------#
#----------------------------------------#-----------------------------------#------------------------------#------------------#
#--------------##############------------#-----------------------------------#------------------------------#------------------#
#--------------*************#-----------###############################------#------------------------------#------------------#
#------------***************#-------------------#----------------------------#------------------------------#------------------#
#--------*******************#-------------------#-----------------------------------------------------------#------------------#
#-----**********************#-------------------#----------------------------#------------------------------####################
#-----#######################-------------------#--------------############################----##------------------------------#
#---------------------------#-------------------#---------------------------------------#-------#------------------------------#
#---------------------------#-----------------------------------------------------------#-------#------------------------------#
#-------#-------------------#-----------------------------------------------------------#-------#------------------------------#
#-------#-------------------#------##############---------------------------#---------**#-----##################################
#-------#-------------------#-------------------#----0--------#-------------#------*****#,,,,,#+++++++++++++++#++++++++++++++++#
#-------#-------------------#-------------------#----0--------#-------------#----***#####,,,,,#+++++++++++++++#++++++++++++++++#
#-------#-------------------#-------------------#----0--------#-------------#***********#,,,,,#+++++++++++++++#++++++++++++++++#
############----------------#-------------------#----0--------#-------------#***********#,,,,,#++++++++++++++++++++++++++++++++#
#,,,,,,,,,,,,,,,------------#-------------------#----0-----##################***********#######++++++++++++++++++++++++++++B+++#
#,,,,,,,,,,,,,,,------------#-------------------#----0----------------------#*****************D++++++++++++++++++++++++++++++++#
#------------------##########-------------------#----0000000000-------------#*****************#+++++++++++#++++++++++++++++++++#
#---------------------------#-------------------#---------------------------###***************#+++++++++++#++++++++++++++++++++#
################################################################################################################################