################################################################################################################################
#-X----------##########---------------------------------#------------------------------------------------#-------------,,,,,,,,#
#--------------------##---------------------------------#------------------------------------------------#-------------,,,,,,,,#
#--------------------##---------------------------------#------------------------------------------------#-------------,,,,,,,,#
###########----------##---------------------------------#------------------------------------------------#-------------,,,,,,,,#
#*********#----------##---------------------------------#---------------------------------#--------------#---------------------#
#*********#----------#########################Y##########################-----------------#--------------#---------------------#
#*********#----------##-------------------------------------------------------------------#--------------#---------------------#
#*********Y-------------------------------------------------------------------------------#--------------#---------------------#
#*********#-------------------------------------------------------------------------------#--------------#---------------------#
#*********#-------------------------------------------------------------------------------#--------------#----YYY---############
###########---------------------------------------------------#############################------------------------------------#
#-----------------------------------------------------------------------------------------#------------------------------------#
#-----------------------------------------------------------------------------------------##########---------------------------#
#--------------------#################################------------------------------------#------------------------------------#
#-------------------------------#----------------------------------------------------------------------------------------------#
#-------------------------------#----------------------------------------------------------------------------------------------#
#-------------------------------#----------------------------------------------------------------------------------------------#
#-------------------------------#-----------------------#-----------------##########################---------------------------#
#-------------------------------#-----------------------#-----------------#----------------------------------------------------#
######################---------------------#------------#-----------------#----------------------------------------------------#
#,,,,,,,-----------------------------------#------------#---------------,,#----------------------------------------------------#
#,,,,--------------------------------------#--------------------------,,,,#----------------------------------------------------#
#,,,,,,,,,,,-------------------------------#-----------------------,,,,,,,#--------------------#################################
#,,,,,,,,,,,,,,,---------------------------#--------------------,,,,,,,,,,#---------#-----------------------#******************#
#,,,,,,,,,,,,,,,,,,,,----------------------#------------###################---------#-----------------------#******************#
#,,,,,,,,,,,,,,,,,,,,----------------------#------------------------------#---------#-----------------------#******************#
#########################------------------#------------------------------#---------#-----------------------#******************#
#-----------------#------------------------#------------------------------#--------####################-----#******************#
#-----------------#------------------------################################---------------------------------#******************#
#-----------------#------------------------#------------------------------#---------------------------------#******************#
#-----------------#------------------------#------------------------------#---------------------------------#******************#
#-----------------#------------------------#------------------------------#---------------------------------#******************#
#-----------------#------------------------#------------------------------#----------------##################******************#
#-----------------Y------------------------#--------------------#---------#------------------------****************************#
#-----------------#-----------################------------------#---------#------------------**********************************#
#-----------------#--------------------------#------------------#---------#----------------------******************************#
#-----------------#--------------------------#------------------#---------#---------------------------*************************#
#-----------------#--------------------------#------------------#---------#--------------------------------********************#
###################--------------------------#------------------#---------#---------------------------------*******************#
#*****K*****#--------------------------------#------------------#--------------------------------------------******************#
#***********#---------------------------------------------------#-------------------------######################################
#***********#---------------------------------------------------#-------------------#-----------------------#------------------#
#***********#--------------------------------------------##############-------------#-----------------------#------------------#
#***********#-----------------------------------------------------------------------#-----------------------#------------------#
###------######################################-------------------------------------#------------------------------------------#
#------------------#----------------------------------------------------------------#------------------------------------------#
#-----------------------------------------------------------------------------------#---------###################--------------#
#-----------------------------------------------------------------------------------#------------------------------------------#
#------------------#----------------------------------------------------------------#-----------------------#------------------#
#------------------#--------------------------------------#-------------------------#-----------------------#------------------#
####################--------------------------------------#-------------------------#-----------------------#------------------#
#---------------------------------------------------------#-------------------------#-----------------------#------------------#
#---------------------------------------------------------#-------------------------#-----------------------#------------------#
#----------------------------###################################################################################################
#----------------------------#**************************************************-----------------------------------------------#
#----------------------------#**************************************************-----------------------------------------------#
#----------------#############-----------------------------------------------------------------------###########################
#----------------------------#-------------------------------------------------------------------------------------------------#
#----------------------------#----------------------------------------------#--------------------#-----------------------------#
#----------------------------#----------------------------------------------#--------------------#-----------------------------#
#---------------------------------------------------------------------------#--------------------#############-----------------#
#---------------------------------------------------------------------------#--------------------#-----------------------------#
#---------------------------------------------------------------------------#--------------------#-----------------------------#
#######################################################---------------------#--------------------#------------------############
#------------------#---------------------#----------------------------------#--------------------#-----------------------------#
#------------------#---------------------#-------------------------------------------------------#-----------------------------#
#------------------#---------------------#-------------------------------------------------------#-----------------------------#
#------------------#---------------------#-------------------------------------------------------#-----------------,,,,,,,,,,,,#
#------------------#---------------------#----------------------##################################---------------,,,,,,,,,,,,,,#
#------------------#---------------------#------------------------------------#------------------#-------------,,,,,,,,,,,,,,,,#
#------------------#---------------------#------------------------------------#------------------#----------####################
####-----###########---------------------#------------------------------------#------------------------------------------------#
#----------------------------------------#------------------------------------#------------------------------------------------#
#----------------------------------------#--------------#---------------------#------------------------------------------------#
#----------------------------------------#--------------#---------------------#------------------------------------------------#
#----------------------------------------#--------------#---------------------#------------------------------------------------#
##################-----------------------#--------------#---------------------#------------------------------------------------#
#----------------------------------------#-------------------------------------------------------------------------------------#
#----------------------------------------#--------------------------------------------------------------#----------------------#
#----------------------------------------########################################-----------------------####################---#
#----------------------------------------#--------------------------------------------------------------#----------------------#
#----------------------------------------#--------------------------------------------------------------#----------------------#
#------------##############################################----------#----------------------------------#----------------------#
#------------#*******************************************************#----------------------------------#----------------------#
#------------#*******************************************************#----------------------------------#----------------------#
#------------#*******************************************************#-------------######################----------------------#
#------------#*******************************************************#----------------------------------#----------------------#
#------------#*******************************************************#----------------------------------#----------------------#
#------------#*******************************************************#----------------------------------#----------------------#
#------------#*******************************************************#----------------------------------#----------------------#
#------------################################################################---------------------------#----------------------#
#-------------------------------------------------------------------------------------------------------#----------------------#
#------------------------------------------------------------------------------------------------------------------------------#
#------------------------------------------------------------------------------------------------------------------------------#
################################------------------------#######################################------------#-------------------#
#------------------------------#------------------------#--------------------------------------------------#-------------------#
#-------,,,,,,,,,,,------------#------------------------#***********---------------------------------------#-------------------#
#-------,,,,,,,,,,,------------#------------------------#***********---------------------------------------#-------------------#
#-------###########------------#------------------------#***********##############--------------------##############-----------#
#------------------------------#------------------------#***********##############--------------------#------------------------#
#------------------------------#------------------------#***********----------------------------------#------------------------#
#------------------------------#------------------------#***********----------------------------------#------------------------#
#------------------------------#---------#--------------#---------------------------------------------#------------------------#
#------------------------------#---------#--------------######################--------#######################------------------#
#------#########################---------#-----------------------------------#------------------------------#------------------#
#----------------------------------------#-----------------------------------#------------------------------#------------------#
#----------------------------------------#-----------------------------------#------------------------------#------------------#
#--------------##############------------#-----------------------------------#------------------------------#------------------#
#--------------*************#-----------###############################------#------------------------------#------------------#
#------------***************#-------------------#----------------------------#------------------------------#------------------#
#--------*******************#-------------------#-----------------------------------------------------------#------------------#
#-----**********************#-------------------#----------------------------#------------------------------####################
#-----#######################-------------------#--------------############################----##------------------------------#
#---------------------------#-------------------#---------------------------------------#-------#------------------------------#
#---------------------------#-----------------------------------------------------------#-------#------------------------------#
#-------#-------------------#-----------------------------------------------------------#-------#------------------------------#
#-------#-------------------#------##############---------------------------#---------**#-----##################################
#-------#-------------------#-------------------#-------------#-------------#------*****#,,,,,#+++++++++++++++#++++++++++++++++#
#-------#-------------------#-------------------#-------------#-------------#----***#####,,,,,#+++++++++++++++#++++++++++++++++#
#-------#-------------------#-------------------#-------------#-------------#***********#,,,,,#+++++++++++++++#++++++++++++++++#
############----------------#-------------------#-------------#-------------#***********#,,,,,#++++++++++++++++++++++++++++++++#
#,,,,,,,,,,,,,,,------------#-------------------#----------##################***********#######++++++++++++++++++++++++++++B+++#
#,,,,,,,,,,,,,,,------------#-------------------#---------------------------#*****************D++++++++++++++++++++++++++++++++#
#------------------##########-------------------#---------------------------#*****************#+++++++++++#++++++++++++++++++++#
#---------------------------#-------------------#---------------------------###***************#+++++++++++#++++++++++++++++++++#
################################################################################################################################