################################################################################################################################
#-X----------##########---------------------------------#------------------------------------------------#---------------------#
#--------------------##---------------------------------#------------------------------------------------#---------------------#
#--------------------##---------------------------------#------------------------------------------------#---------------------#
###########----------##---------------------------------#------------------------------------------------#---------------------#
#---------#----------##---------------------------------#---------------------------------#--------------#---------------------#
#---------#----------#########################Y##########################-----------------#--------------#---------------------#
#---------#----------##-------------------------------------------------------------------#--------------#---------------------#
#---------Y-------------------------------------------------------------------------------#--------------#---------------------#
#---------#-------------------------------------------------------------------------------#--------------#---------------------#
#---------#-------------------------------------------------------------------------------#--------------#----YYY---############
###########---------------------------------------------------#############################------------------------------------#
#-----------------------------------------------------------------------------------------#------------------------------------#
#-----------------------------------------------------------------------------------------##########---------------------------#
#--------------------#################################------------------------------------#------------------------------------#
#-------------------------------#----------------------------------------------------------------------------------------------#
#-------------------------------#----------------------------------------------------------------------------------------------#
#-------------------------------#----------------------------------------------------------------------------------------------#
#-------------------------------#-----------------------#-----------------##########################---------------------------#
#-------------------------------#-----------------------#-----------------#----------------------------------------------------#
######################---------------------#------------#-----------------#----------------------------------------------------#
#------------------------------------------#------------#-----------------#----------------------------------------------------#
#------------------------------------------#------------------------------#----------------------------------------------------#
#------------------------------------------#------------------------------#--------------------#################################
#------------------------------------------#------------------------------#---------#-----------------------#------------------#
#------------------------------------------#------------###################---------#-----------------------#------------------#
#------------------------------------------#------------------------------#---------#-----------------------#------------------#
#########################------------------#------------------------------#---------#-----------------------#------------------#
#-----------------#------------------------#------------------------------#--------####################-----#------------------#
#-----------------#------------------------################################---------------------------------#------------------#
#-----------------#------------------------#------------------------------#---------------------------------#------------------#
#-----------------#------------------------#------------------------------#---------------------------------#------------------#
#-----------------#------------------------#------------------------------#---------------------------------#------------------#
#-----------------#------------------------#------------------------------#----------------##################------------------#
#-----------------Y------------------------#--------------------#---------#----------------------------------------------------#
#-----------------#-----------################------------------#---------#----------------------------------------------------#
#-----------------#--------------------------#------------------#---------#----------------------------------------------------#
#-----------------#--------------------------#------------------#---------#----------------------------------------------------#
#-----------------#--------------------------#------------------#---------#----------------------------------------------------#
###################--------------------------#------------------#---------#----------------------------------------------------#
#-----K-----#--------------------------------#------------------#--------------------------------------------------------------#
#-----------#---------------------------------------------------#-------------------------######################################
#-----------#---------------------------------------------------#-------------------#-----------------------#------------------#
#-----------#--------------------------------------------##############-------------#-----------------------#------------------#
#-----------#-----------------------------------------------------------------------#-----------------------#------------------#
###------######################################-------------------------------------#------------------------------------------#
#------------------#----------------------------------------------------------------#------------------------------------------#
#-----------------------------------------------------------------------------------#---------###################--------------#
#-----------------------------------------------------------------------------------#------------------------------------------#
#------------------#----------------------------------------------------------------#-----------------------#------------------#
#------------------#--------------------------------------#-------------------------#-----------------------#------------------#
####################--------------------------------------#-------------------------#-----------------------#------------------#
#---------------------------------------------------------#-------------------------#-----------------------#------------------#
#---------------------------------------------------------#-------------------------#-----------------------#------------------#
#----------------------------###################################################################################################
#----------------------------#-------------------------------------------------------------------------------------------------#
#----------------------------#-------------------------------------------------------------------------------------------------#
#----------------#############-----------------------------------------------------------------------###########################
#----------------------------#-------------------------------------------------------------------------------------------------#
#----------------------------#----------------------------------------------#--------------------#-----------------------------#
#----------------------------#----------------------------------------------#--------------------#-----------------------------#
#---------------------------------------------------------------------------#--------------------#############-----------------#
#---------------------------------------------------------------------------#--------------------#-----------------------------#
#---------------------------------------------------------------------------#--------------------#-----------------------------#
#######################################################---------------------#--------------------#------------------############
#------------------#---------------------#----------------------------------#--------------------#-----------------------------#
#------------------#---------------------#-------------------------------------------------------#-----------------------------#
#------------------#---------------------#-------------------------------------------------------#-----------------------------#
#------------------#---------------------#-------------------------------------------------------#-----------------------------#
#------------------#---------------------#----------------------##################################-----------------------------#
#------------------#---------------------#------------------------------------#------------------#-----------------------------#
#------------------#---------------------#------------------------------------#------------------#----------####################
####-----###########---------------------#------------------------------------#------------------------------------------------#
#----------------------------------------#------------------------------------#------------------------------------------------#
#----------------------------------------#--------------#---------------------#------------------------------------------------#
#----------------------------------------#--------------#---------------------#------------------------------------------------#
#----------------------------------------#--------------#---------------------#------------------------------------------------#
##################-----------------------#--------------#---------------------#------------------------------------------------#
#----------------------------------------#-------------------------------------------------------------------------------------#
#----------------------------------------#--------------------------------------------------------------#----------------------#
#----------------------------------------########################################-----------------------####################---#
#----------------------------------------#--------------------------------------------------------------#----------------------#
#----------------------------------------#--------------------------------------------------------------#----------------------#
#------------##############################################----------#----------------------------------#----------------------#
#------------#-------------------------------------------------------#----------------------------------#----------------------#
#------------#-------------------------------------------------------#----------------------------------#----------------------#
#------------#-------------------------------------------------------#-------------######################----------------------#
#------------#-------------------------------------------------------#----------------------------------#----------------------#
#------------#-------------------------------------------------------#----------------------------------#----------------------#
#------------#-------------------------------------------------------#----------------------------------#----------------------#
#------------#-------------------------------------------------------#----------------------------------#----------------------#
#------------################################################################---------------------------#----------------------#
#-------------------------------------------------------------------------------------------------------#----------------------#
#------------------------------------------------------------------------------------------------------------------------------#
#------------------------------------------------------------------------------------------------------------------------------#
################################------------------------#######################################------------#-------------------#
#------------------------------#------------------------#--------------------------------------------------#-------------------#
#------------------------------#------------------------#--------------------------------------------------#-------------------#
#------------------------------#------------------------#--------------------------------------------------#-------------------#
#-------###########------------#------------------------#-----------##############--------------------##############-----------#
#------------------------------#------------------------#-----------##############--------------------#------------------------#
#------------------------------#------------------------#---------------------------------------------#------------------------#
#------------------------------#------------------------#---------------------------------------------#------------------------#
#------------------------------#---------#--------------#---------------------------------------------#------------------------#
#------------------------------#---------#--------------######################--------#######################------------------#
#------#########################---------#-----------------------------------#------------------------------#------------------#
#----------------------------------------#-----------------------------------#------------------------------#------------------#
#----------------------------------------#-----------------------------------#------------------------------#------------------#
#--------------##############------------#-----------------------------------#------------------------------#------------------#
#---------------------------#-----------###############################------#------------------------------#------------------#
#---------------------------#-------------------#----------------------------#------------------------------#------------------#
#---------------------------#-------------------#-----------------------------------------------------------#------------------#
#---------------------------#-------------------#----------------------------#------------------------------####################
#-----#######################-------------------#--------------############################----##------------------------------#
#---------------------------#-------------------#---------------------------------------#-------#------------------------------#
#---------------------------#-----------------------------------------------------------#-------#------------------------------#
#-------#-------------------#-----------------------------------------------------------#-------#------------------------------#
#-------#-------------------#------##############---------------------------#-----------#-------################################
#-------#-------------------#-------------------#-------------#-------------#-----------#-------#-------------#----------------#
#-------#-------------------#-------------------#-------------#-------------#-------#####-------#-------------#----------------#
#-------#-------------------#-------------------#-------------#-------------#-----------#-------#-------------#----------------#
############----------------#-------------------#-------------#-------------#-----------#-------#------------------------------#
#---------------------------#-------------------#----------##################-----------#########------------------------------#
#---------------------------#-------------------#---------------------------#-------------------D------------------------------#
#------------------##########-------------------#---------------------------#-------------------#---------#------------B-------#
#---------------------------#-------------------#---------------------------###-----------------#---------#--------------------#
################################################################################################################################